############################
############################
############################
/------------\/------------\
|............||............|
|./--\./---\.||./---\./--\.|
|o|##|.|###|.||.|###|.|##|o|
|.\--/.\---/.\/.\---/.\--/.|
|..........................|
|./--\./\./------\./\./--\.|
|.\--/.||.\--\/--/.||.\--/.|
|......||....||....||......|
\----\.|\--\ || /--/|./----/
#####|.|/--/ || \--\|.|#####
#####|.||          ||.|#####
#####|.|| /--==--\ ||.|#####
-----/.\/ |      | \/.\-----
      .   |      |   .      
-----\./\ |      | /\./-----
#####|.|| \------/ ||.|#####
#####|.||          ||.|#####
#####|.|| /------\ ||.|#####
/----/.\/ \--\/--/ ||.\----\
|............||............|
|./--\./---\.||./---\./--\.|
|.\-\|.\---/.\/.\---/.|/-/.|
|o..||.......  .......||..o|
\-\.||./\./------\./\.||./-/
/-/.\/.||.\--\/--/.||.\/.\-\
|......||....||....||......|
|./----/\--\.||./--/\----\.|
|.\--------/.\/.\--------/.|
|..........................|
\--------------------------/
############################
############################